EyeBlinkLeft	CTRL_expressions_eyeBlinkL	head_cm1_color_head_wm1_blink_L	head_wm1_normal_head_wm1_blink_L
0.3	head_cm1_color_head_wm1_squintInner_L	head_wm1_normal_head_wm1_squintInner_L
EyeLookDownLeft	CTRL_expressions_eyeLookDownL	head_cm1_color_head_wm1_blink_L	head_wm1_normal_head_wm1_blink_L
EyeLookInLeft	CTRL_expressions_eyeLookRightL
EyeLookOutLeft	CTRL_expressions_eyeLookLeftL
EyeLookUpLeft	CTRL_expressions_eyeLookUpL
EyeSquintLeft	CTRL_expressions_eyeSquintInnerL
EyeWideLeft	CTRL_expressions_eyeWidenL
EyeBlinkRight	CTRL_expressions_eyeBlinkR	head_cm1_color_head_wm1_blink_R	head_wm1_normal_head_wm1_blink_R
0.3	head_cm1_color_head_wm1_squintInner_R	head_wm1_normal_head_wm1_squintInner_R
EyeLookDownRight	CTRL_expressions_eyeLookDownR	head_cm1_color_head_wm1_blink_R	head_wm1_normal_head_wm1_blink_R
EyeLookInRight  CTRL_expressions_eyeLookLeftR
EyeLookOutRight	CTRL_expressions_eyeLookRightR
EyeLookUpRight	CTRL_expressions_eyeLookUpR
EyeSquintRight	CTRL_expressions_eyeSquintInnerR
EyeWideRight	CTRL_expressions_eyeWidenR
JawForward	CTRL_expressions_jawFwd
JawRight	CTRL_expressions_jawRight
JawLeft	CTRL_expressions_jawLeft
JawOpen	CTRL_expressions_jawOpen	head_cm1_color_head_wm1_jawOpen	head_wm1_normal_head_wm1_jawOpen
MouthFunnel	CTRL_expressions_mouthLipsPurseUL	CTRL_expressions_mouthLipsPurseUR	CTRL_expressions_mouthLipsPurseDL	CTRL_expressions_mouthLipsPurseDR
0.41    CTRL_expressions_mouthLipsTogetherUL	CTRL_expressions_mouthLipsTogetherUR	CTRL_expressions_mouthLipsTogetherDL		CTRL_expressions_mouthLipsTogetherDR
0.75    CTRL_expressions_mouthFunnelUL	CTRL_expressions_mouthFunnelUR	CTRL_expressions_mouthFunnelDL	CTRL_expressions_mouthFunnelDR
0.53    head_cm1_color_head_wm1_purse_UL	head_cm1_color_head_wm1_purse_UR	head_cm1_color_head_wm1_purse_DL	head_cm1_color_head_wm1_purse_DR	head_wm1_normal_head_wm1_purse_UL	head_wm1_normal_head_wm1_purse_UR	head_wm1_normal_head_wm1_purse_DL	head_wm1_normal_head_wm1_purse_DR
MouthRight  CTRL_expressions_mouthRight	head_cm3_color_head_wm3_smile_R	head_wm3_normal_head_wm3_smile_R
0.5 head_cm1_color_head_wm13_lips_UL	head_cm1_color_head_wm13_lips_UR	head_cm1_color_head_wm13_lips_DL	head_cm1_color_head_wm13_lips_DR	head_wm1_normal_head_wm13_lips_UL	head_wm1_normal_head_wm13_lips_UR	head_wm1_normal_head_wm13_lips_DL	head_wm1_normal_head_wm13_lips_DR	head_cm3_color_head_wm3_cheekRaiseInner_R	head_cm3_color_head_wm3_cheekRaiseOuter_R	head_wm3_normal_head_wm3_cheekRaiseInner_R	head_wm3_normal_head_wm3_cheekRaiseOuter_R
MouthLeft	CTRL_expressions_mouthLeft	head_cm3_color_head_wm3_smile_L	head_wm3_normal_head_wm3_smile_L
0.5	head_cm1_color_head_wm13_lips_UL	head_cm1_color_head_wm13_lips_UR	head_cm1_color_head_wm13_lips_DL	head_cm1_color_head_wm13_lips_DR	head_wm1_normal_head_wm13_lips_UL	head_wm1_normal_head_wm13_lips_UR	head_wm1_normal_head_wm13_lips_DL	head_wm1_normal_head_wm13_lips_DR	head_cm3_color_head_wm3_cheekRaiseInner_L	head_cm3_color_head_wm3_cheekRaiseOuter_L	head_wm3_normal_head_wm3_cheekRaiseInner_L	head_wm3_normal_head_wm3_cheekRaiseOuter_L
MouthSmileLeft	CTRL_expressions_mouthCornerPullL	head_cm3_color_head_wm3_smile_L	head_wm3_normal_head_wm3_smile_L	head_cm1_color_head_wm13_lips_UL	head_cm1_color_head_wm13_lips_UR	head_wm1_normal_head_wm13_lips_UL	head_wm1_normal_head_wm13_lips_UR
0.8	head_cm3_color_head_wm3_cheekRaiseInner_L	head_cm3_color_head_wm3_cheekRaiseOuter_L	head_wm3_normal_head_wm3_cheekRaiseInner_L	head_wm3_normal_head_wm3_cheekRaiseOuter_L
MouthSmileRight	CTRL_expressions_mouthCornerPullR	head_cm3_color_head_wm3_smile_R	head_wm3_normal_head_wm3_smile_R	head_cm1_color_head_wm13_lips_UL	head_cm1_color_head_wm13_lips_UR	head_wm1_normal_head_wm13_lips_UL	head_wm1_normal_head_wm13_lips_UR
0.8	head_cm3_color_head_wm3_cheekRaiseInner_R	head_cm3_color_head_wm3_cheekRaiseOuter_R	head_wm3_normal_head_wm3_cheekRaiseInner_R	head_wm3_normal_head_wm3_cheekRaiseOuter_R
MouthFrownLeft	CTRL_expressions_mouthCornerDepressL
MouthFrownRight CTRL_expressions_mouthCornerDepressR
MouthDimpleLeft CTRL_expressions_mouthDimpleL
MouthDimpleRight	CTRL_expressions_mouthDimpleR
MouthStretchLeft	head_wm3_color_head_wm13_lips_UL	head_wm3_color_head_wm13_lips_DL	head_wm3_normal_head_wm13_lips_UL	head_wm3_normal_head_wm13_lips_DL	head_cm2_color_head_wm2_mouthStretch_L	head_wm2_normal_head_wm2_mouthStretch_L	CTRL_expressions_mouthStretchL
MouthStretchRight	head_wm3_color_head_wm13_lips_UL	head_wm3_color_head_wm13_lips_DL	head_wm3_normal_head_wm13_lips_UL	head_wm3_normal_head_wm13_lips_DL	head_cm2_color_head_wm2_mouthStretch_R	head_wm2_normal_head_wm2_mouthStretch_R	CTRL_expressions_mouthStretchR
MouthRollLower	CTRL_expressions_mouthLowerLipRollInL	CTRL_expressions_mouthLowerLipRollInR
MouthRollUpper	CTRL_expressions_mouthUpperLipRollInL	CTRL_expressions_mouthUpperLipRollInR
MouthShrugLower	head_cm1_color_head_wm1_chinRaise_L	head_wm1_normal_head_wm1_chinRaise_L	head_cm1_color_head_wm1_chinRaise_R	head_wm1_normal_head_wm1_chinRaise_R	CTRL_expressions_jawChinRaiseDL	CTRL_expressions_jawChinRaiseDR
MouthShrugUpper	CTRL_expressions_jawChinRaiseUL	CTRL_expressions_jawChinRaiseUR
MouthPressLeft  CTRL_expressions_mouthPressUL	CTRL_expressions_mouthPressDL
MouthPressRight	CTRL_expressions_mouthPressUR	CTRL_expressions_mouthPressDR
MouthLowerDownLeft	CTRL_expressions_mouthLowerLipDepressL
MouthLowerDownRight	CTRL_expressions_mouthLowerLipDepressR
MouthUpperUpLeft	CTRL_expressions_mouthUpperLipRaiseL
MouthUpperUpRight	CTRL_expressions_mouthUpperLipRaiseR
BrowDownLeft	CTRL_expressions_browDownL	head_cm2_color_head_wm2_browsDown_L	head_wm2_normal_head_wm2_browsDown_L
0.04	CTRL_expressions_browLateralL	head_cm2_color_head_wm2_browsLateral_L	head_wm2_normal_head_wm2_browsLateral_L
BrowDownRight	CTRL_expressions_browDownR	head_cm2_color_head_wm2_browsDown_R	head_wm2_normal_head_wm2_browsDown_R
0.04	CTRL_expressions_browLateralR	head_cm2_color_head_wm2_browsLateral_R	head_wm2_normal_head_wm2_browsLateral_R
BrowInnerUp	CTRL_expressions_browLateralL	CTRL_expressions_browLateralR	CTRL_expressions_browRaiseInL	CTRL_expressions_browRaiseInR	head_cm2_color_head_wm2_browsLateral_L	head_cm2_color_head_wm2_browsLateral_R	head_wm2_normal_head_wm2_browsLateral_L	head_wm2_normal_head_wm2_browsLateral_R	head_cm1_color_head_wm1_browsRaiseInner_L	head_cm1_color_head_wm1_browsRaiseInner_R	head_wm1_normal_head_wm1_browsRaiseInner_L	head_wm1_normal_head_wm1_browsRaiseInner_R
BrowOuterUpLeft	CTRL_expressions_browRaiseInL	CTRL_expressions_browRaiseOuterL	head_cm1_color_head_wm1_browsRaiseInner_L	head_cm1_color_head_wm1_browsRaiseOuter_L	head_wm1_normal_head_wm1_browsRaiseInner_L	head_wm1_normal_head_wm1_browsRaiseOuter_L
0.04	CTRL_expressions_browLateralL	head_cm2_color_head_wm2_browsLateral_L	head_wm2_normal_head_wm2_browsLateral_L
BrowOuterUpRight	CTRL_expressions_browRaiseInR	CTRL_expressions_browRaiseOuterR	head_cm1_color_head_wm1_browsRaiseInner_R	head_cm1_color_head_wm1_browsRaiseOuter_R	head_wm1_normal_head_wm1_browsRaiseInner_R	head_wm1_normal_head_wm1_browsRaiseOuter_R
0.04	CTRL_expressions_browLateralR	head_cm2_color_head_wm2_browsLateral_R	head_wm2_normal_head_wm2_browsLateral_R
CheekPuff	CTRL_expressions_mouthCheekBlowL	CTRL_expressions_mouthCheekBlowR	CTRL_expressions_mouthLipsBlowL	CTRL_expressions_mouthLipsBlowR
CheekSquintLeft	CTRL_expressions_eyeCheekRaiseL
0.8	head_cm3_color_head_wm3_cheekRaiseInner_L	head_cm3_color_head_wm3_cheekRaiseOuter_L	head_cm3_color_head_wm3_cheekRaiseUpper_L	head_wm3_normal_head_wm3_cheekRaiseInner_L	head_wm3_normal_head_wm3_cheekRaiseOuter_L	head_wm3_normal_head_wm3_cheekRaiseUpper_L
0.04	head_cm2_color_head_wm2_browsLateral_L	head_wm2_normal_head_wm2_browsLateral_L
CheekSquintRight	CTRL_expressions_eyeCheekRaiseR
0.8	head_cm3_color_head_wm3_cheekRaiseInner_R	head_cm3_color_head_wm3_cheekRaiseOuter_R	head_cm3_color_head_wm3_cheekRaiseUpper_R	head_wm3_normal_head_wm3_cheekRaiseInner_R	head_wm3_normal_head_wm3_cheekRaiseOuter_R	head_wm3_normal_head_wm3_cheekRaiseUpper_R
0.04	head_cm2_color_head_wm2_browsLateral_R	head_wm2_normal_head_wm2_browsLateral_R
NoseSneerLeft	CTRL_expressions_noseWrinkleL	head_cm2_color_head_wm2_noseWrinkler_L	head_wm2_normal_head_wm2_noseWrinkler_L
0.2	head_cm2_color_head_wm2_browsDown_L	head_wm2_normal_head_wm2_browsDown_L
0.3	head_cm2_color_head_wm2_browsLateral_L	head_wm2_normal_head_wm2_browsLateral_L
NoseSneerRight	CTRL_expressions_noseWrinkleR	head_cm2_color_head_wm2_noseWrinkler_R	head_wm2_normal_head_wm2_noseWrinkler_R
0.2	head_cm2_color_head_wm2_browsDown_R	head_wm2_normal_head_wm2_browsDown_R
0.3	head_cm2_color_head_wm2_browsLateral_R	head_wm2_normal_head_wm2_browsLateral_R